6 6 
9 E b A a E
3 a E b 8 8
D d 9 a 4 7
5 5 3 e 5 D
1 0 C 9 2 6
7 7 5 3 a e
