7 7
9 A a 6 F 2 C
5 9 A c B 3 D
5 5 F 3 E 5 A
7 3 A e D 1 B
1 3 C 9 F 7 E
5 9 A b E 4 C
5 5 F 3 A 9 D
